# - # # # # # # # # # # # # # # # # # # 
# - - - - - - - - - - - - - - - - - # # 
# # # # # - # # - # # - # # # - # - - #
# - # # # - # - - # # - # # - - # - # # 
# - # - - - # # # # # # # # # - # - - # 
# - - - # - - - - # - # # - # - # # # #
# - # # # # - # - - - - - - - - - - - #
# - # # - - - # # # # # # # - # # - # #
# - - - - # # - # # - - - - - - - - - #
# # # # # # - # # # # # # # # # # # # # 

